1100100110
1111000111
1101101111
1111110111
1111110111
1111110111
1111110111
1111110111
1111110111
1111111111